R 200   140

SO ./texture/Mur_noir_SO.XPM
NO ./texture/Mur_noir_NO.XPM
WE ./texture/Mur_gris_WE.XPM
EA ./texture/Mur_gris_EA.XPM

S ./texture/master_sword.XPM

F 33, 47, 40
C 66, 0, 0

    11111111111111
    1000000200201
11110000010000S111
100020001 10000111111
1X002000110200200000111
11111111 11111111111111
