R 800  600

NO ./texture/Mur_noir_1.XPM
SO ./texture/Mur_noir_2.XPM
WE ./texture/Mur_gris_2.XPM
EA ./texture/Mur_gris_1.XPM

S ./texture/master_sword.XPM

F 33, 47, 61
C 66, 73, 73

    1111111111111111111111111
    1000000000110000000000001
    1011000001110000002001111
1111000000000000000000001
111111111011000001110000011111111
100000000011000001110111111111111
111101111111110111000000100S21
111101111 11111011101010010001
110000001 1010101110000001001
100020001110000001100000010001   111
100000000000000011010100100001   101
1100000111010101111101111000111  111
11110111 1110101 1011110100011
11111111 1111111 111111111111
